#########
#...@####
####.####
####.####
#...&####
##.######
##....###
#########
#########
