#########
#########
#########
#### ####
###   ###
#### ####
#########
#########
#########
