##############################
#...##....#..................#
#.#..#.##.##.#...............#
#.##.#.......................#
#....##.##.##................#
#.##.......#.................#
#..#.##.#####................#
##.#...@.....................#
#....##.##.##................#
#.#.###.#....................#
#.#.#...##.##................#
#.....#.#...#................#
#.##.##...###................#
#.......#....................#
#............................#
#............................#
#............................#
#............................#
#............................#
#............................#
#............................#
#............................#
#............................#
##############################