##########
#...@#####
####.#####
####.#####
#...&#####
##.#######
##....####
####.#####
####.#####
####.#####