###############
#&..##....#...#
#.#..#.##.##.##
#.##.#........#
#....##.##.##.#
#.##.......#..#
#..#.##.#####.#
##.#...@......#
#....##.##.##.#
#.#.###.#.....#
#.#.#...##.##.#
#.....#.#...#.#
#.##.##...###.#
#.......#.....#
###############