##########
#...@....#
#.##.###.#
#.##.###.#
#.#......#
#.#.#.##.#
#...#.##.#
#.###.##.#
#........#
##########