##############################
#....#&.......#.......&#.....#
#....#.###.##.#.##.###.#.....#
#....#.................#.....#
#....#.##.#.#####.#.##.#.....#
#....#....#...#...#....#.....#
#....####.###.#.###.####.....#
#.......#.#.......#.#........#
#########.#.##.##.#.##########
............#.@.#.............
#########.#.##.##.#.##########
#.......#.#.......#.#........#
#....####.#.#####.#.####.....#
#....#........#........#.....#
#....#.##.###.#.###.##.#.....#
#....#..#...........#..#.....#
#....##.#.#.#####.#.#.##.....#
#....#....#...#...#....#.....#
#....#.######.#.######.#.....#
#....#&...............&#.....#
##############################