########.###########.########
.....#........#........#.....
#.##...###.##.#.##.###......#
#.##.#.................#....#
#.##.#.##.#.#####.#.##.#....#
#....#....#...#...#....#....#
####.####.###.#.###.####.####
#.........#.......#.........#
#.#######.#.##.##.#.#######.#
............#.@.#............
#.#######.#.##.##.#.#######.#
#.........#.......#.........#
#.##.####.#.#####.#.####.##.#
#....#........#........#....#
###.##.##.###.#.###.##.##.###
#....#..#.....&.....#..#....#
#.#####.#.#.#####.#.#.#####.#
#....#....#...#...#....#....#
#....#.######.#.######.#.##.#
#...........................#
########.###########.########
